1 4000 150 0 100 300 8100 0 0
1 -4000 150 0 100 300 8100 0 0
1 0 150 4000 7900 300 100 180 0
1 0 150 -4000 7900 300 100 180 0
1 -3625 150 300 650 300 200 180 0
1 -3250 150 -400 100 300 2900 0 0
1 -2325 150 -1800 1750 300 100 180 0
1 -1500 150 -2600 100 300 1500 0 0
1 -1650 150 -3400 400 300 100 180 0
1 -3175 150 -3400 1550 300 100 180 0
1 -850 150 -2850 100 300 2200 0 0
1 -700 150 -1800 200 300 100 180 0
1 -550 150 -1700 100 300 300 0 0
1 -500 150 -1500 200 300 100 180 0
1 -350 150 -750 100 300 1600 0 0
1 -1750 150 -1700 100 300 300 0 0
1 -1800 150 -1500 200 300 100 180 0
1 -1950 150 -750 100 300 1600 0 0
1 -1200 150 -750 400 300 800 180 0
1 -1600 150 300 200 300 100 180 0 
1 -1750 150 200 100 300 300 0 0
1 -1800 150 0 200 300 100 180 0
1 -700 150 300 200 300 100 180 0
1 -550 150 200 100 300 300 0 0
1 -500 150 0 200 300 100 180 0
1 -850 150 650 100 300 800 0 0
1 -1725 150 1100 1850 300 100 180 0
1 -2600 150 -50 100 300 2200 0 0
1 -3575 150 1100 750 300 100 180 0
1 -1800 150 2850 100 300 2200 0 0
1 -950 150 1800 1600 300 100 180 0
1 -100 150 1400 100 300 900 0 0
1 1025 150 900 2350 300 100 180 0
1 1350 150 -600 100 300 1300 0 0
1 500 150 0 100 300 1600 90 0
1 950 150 -1300 900 300 100 180 0
1 2800 150 -1300 1200 300 100 180 0
1 450 150 -2600 100 300 2700 0 0
1 3375 150 -600 1150 300 100 180 0
1 2850 150 450 100 300 2000 0 0
1 2250 150 100 100 300 2700 0 0
1 2550 150 1500 700 300 100 180 0
1 -2100 140 -3400 600 280 50 180 1
1 -1800 140 1500 50 280 700 0 2
1 3700 140 -1300 600 280 50 180 3
2 -3400 0 -3300 0 0 0 0 0
2 -2500 0 -2500 0 0 0 0 0
2 -1200 0 -2000 0 0 0 0 0
2 -1200 0 100 0 0 0 0 0
2 -3400 0 3400 0 0 0 0 0
2 -3000 0 3000 0 0 0 0 0
2 3400 0 -3400 0 0 0 0 0
2 3000 0 -3000 0 0 0 0 0
2 2600 0 200 0 0 0 0 0
2 460 0 545 0 0 0 0 0
2 -2361 0 -800 0 0 0 0 0
2 1200 0 -2980 0 0 0 0 0
3 -3200 0 -2000 0 0 0 0 1
3 -3800 0 -3850 0 0 0 0 1
3 -1200 0 -200 0 0 0 0 1
3 -3800 0 1300 0 0 0 0 1
3 700 0 -1600 0 0 0 0 1
4 -3000 0 -2000 0 0 0 0 2
4 -3800 0 -3550 0 0 0 0 2
4 -1900 0 200 0 0 0 0 2
4 -2000 0 3800 0 0 0 0 2
4 700 0 -3600 0 0 0 0 2
5 -3800 0 -3700 0 0 0 0 0
5 -1900 0 -1650 0 0 0 0 0
5 -400 0 1400 0 0 0 0 0
5 3707 0 -777 0 0 0 0 0
5 860 0 -2720 0 0 0 0 0
7 -3500 0 0 0 0 0 0 0
7 -3800 0 0 0 0 0 0 0
7 -3500 0 -400 0 0 0 0 0
7 -3800 0 -400 0 0 0 0 0
7 -3500 0 -800 0 0 0 0 0
7 -3800 0 -800 0 0 0 0 0
7 -3500 0 -1200 0 0 0 0 0
7 -3800 0 -1200 0 0 0 0 0
7 -3500 0 -1600 0 0 0 0 0
7 -3800 0 -1600 0 0 0 0 0
7 -300 0 200 0 0 0 0 0
7 -650 0 500 0 0 0 0 0
8 -1050 0 -2400 0 0 0 180 0
8 -1350 0 -2400 0 0 0 0 0
8 -3650 0 600 0 0 0 90 0
8 2000 0 700 0 0 0 135 0
8 2400 0 -1500 0 0 0 90 0
8 2800 0 -1500 0 0 0 180 0