1 -1600 150 300 650 300 150 180 0
1 -1600 150 -400 650 300 150 180 0
1 -1200 150 -995 150 300 1335 0 0
1 -1200 150 765 150 300 1080 0 0
1 -750 150 -1585 750 300 150 180 0
1 -825 150 1380 900 300 150 180 0
1 -300 150 -1920 150 300 820 0 0
1 -300 150 1590 150 300 570 0 0
1 300 150 -2250 1050 300 150 180 0
1 -825 150 1800 900 300 150 180 0
1 900 150 -2650 150 300 950 0 0
1 -200 150 2875 1650 300 150 180 0
1 3000 150 -3050 4050 300 150 180 0
1 3250 150 -1500 3000 150 2300 180 0
1 -2000 150 3525 150 300 8000 0 0
1 5100 150 2200 150 300 10650 0 0
1 -1100 150 3225 150 300 850 0 0
1 -1775 150 3225 300 300 850 0 0
1 3988 150 5975 2075 300 150 180 0
1 -200 150 3580 1650 300 150 180 0
1 2600 150 5640 700 300 2050 0 0
1 700 150 4140 150 300 1275 0 0
1 1000 150 4700 450 300 150 180 0
1 475 150 4700 300 300 150 180 0
1 -1000 150 4700 1850 300 150 180 0
1 700 150 2275 150 300 1350 0 0
1 887 150 1675 225 300 150 180 0
1 1075 150 2275 150 300 1350 0 0
1 1912 150 2875 1525 300 150 180 0
1 2750 150 1912 150 300 2075 0 0
1 2125 150 800 2600 300 150 180 0
1 2125 150 0 2600 300 150 180 0
1 900 150 -850 150 300 1550 0 0
1 3800 150 1425 750 300 3000 0 0
1 1300 150 6000 150 300 2750 0 0
1 1550 150 7450 6950 300 150 180 0
1 1250 150 250 150 300 350 0 0
1 1850 150 550 150 300 350 0 0
1 2450 150 250 150 300 350 0 0
1 1800 150 5900 400 300 1500 0 0
1 900 140 -1900 100 280 550 0 1
1 1075 140 1240 100 280 740 0 2
1 125 140 4700 400 280 100 180 3
2 2850 0 50 0 0 0 0 0
2 1500 0 50 0 0 0 0 0
2 1200 0 1000 0 0 0 0 0
2 200 0 1200 0 0 0 0 0
2 380 0 -1900 0 0 0 0 0
2 -1660 0 750 0 0 0 0 0
2 1470 0 -1025 0 0 0 0 0
2 -575 0 3300 0 0 0 0 0
2 4670 0 -2880 0 0 0 0 0
2 3233 0 2390 0 0 0 0 0
2 275 0 4120 0 0 0 0 0
2 4375 0 5100 0 0 0 0 0
2 1925 0 7000 0 0 0 0 0
2 4400 0 6735 0 0 0 0 0
2 -1201 0 5780 0 0 0 0 0
2 316 0 5780 0 0 0 0 0
2 1670 0 2270 0 0 0 0 0
2 4340 0 7040 0 0 0 0 0
2 -840 0 6680 0 0 0 0 0
2 1150 0 4400 0 0 0 0 0
3 -1025 0 -1340 0 0 0 0 1
3 700 0 -830 0 0 0 0 1
3 340 0 2600 0 0 0 0 1
3 -1770 0 520 0 0 0 0 1
3 2360 0 2600 0 0 0 0 1
3 530 0 4160 0 0 0 0 1
3 3300 0 5640 0 0 0 0 1
3 3225 0 -2840 0 0 0 0 1
4 -1025 0 1140 0 0 0 0 2
4 -500 0 1580 0 0 0 0 2
4 -1800 0 4200 0 0 0 0 2
4 20 0 -2115 0 0 0 0 2
4 1480 0 1015 0 0 0 0 2
4 3135 0 -240 0 0 0 0 2
4 3215 0 1030 0 0 0 0 2
4 4890 0 5670 0 0 0 0 2
5 -1740 0 -55 0 0 0 0 0
5 915 0 1805 0 0 0 90 0
5 -1800 0 2680 0 0 0 0 0
5 1450 0 2630 0 0 0 90 0
5 1070 0 5050 0 0 0 0 0
5 2640 0 4500 0 0 0 90 0
5 4880 0 -2870 0 0 0 0 0
6 4400 -20 250 0 0 0 -300 350
6 4400 -20 750 0 0 0 -300 400
6 4400 -20 1250 0 0 0 -300 375
6 4400 -20 1750 0 0 0 -300 425
6 4400 -20 2250 0 0 0 -300 350
6 4400 -20 2750 0 0 0 -300 400
7 3350 0 245 0 0 0 0 0
7 3350 0 590 0 0 0 0 0
7 2025 0 2011 0 0 0 270 0
7 2170 0 1845 0 0 0 0 0
7 2025 0 1680 0 0 0 90 0
7 1860 0 1845 0 0 0 180 0
7 4925 0 6515 0 0 0 0 0
7 4925 0 6990 0 0 0 0 0
7 -925 0 3100 0 0 0 180 0
7 -925 0 3390 0 0 0 180 0
8 1160 0 -220 0 0 0 0 0
8 -1360 0 470 0 0 0 220 0
8 1800 0 5000 0 0 0 90 0
8 4040 0 5770 0 0 0 90 0