1 -1775 150 200 300 300 150 180 0
1 -1775 150 -400 300 300 150 180 0
1 -1550 150 1050 150 300 1850 0 0
1 -1083 150 1900 785 300 150 180 0
1 -550 150 1425 280 300 1100 0 0
1 -317 150 950 185 300 150 180 0
1 -150 150 1425 150 300 1100 0 0
1 438 150 1900 1025 300 150 180 0
1 875 150 -75 150 300 3800 0 0
1 -1550 150 -675 150 300 700 0 0
1 -1083 150 -950 785 300 150 180 0
1 -400 150 -265 580 300 1515 0 0
1 -560 150 -1900 2730 300 150 180 0
1 -2000 150 -850 150 300 2250 0 0
1 -1000 150 1510 75 300 620 0 0
1 -1250 150 1510 75 300 620 0 0
2 600 150 -1700 50 300 325 90 200
2 325 150 -1000 50 300 235 90 300
2 75 150 -1300 50 300 325 90 200
3 400 150 -1700 150 300 100 0 200
3 100 150 -1500 150 300 100 0 200
3 -200 150 -1300 150 300 100 0 200
3 -500 150 -1100 150 300 100 0 200